махум	ма̄хум
тан	та̄н
хотпат	хо̄тпат
магыс	ма̄гыс
олы	о̄лы
маньщи	ма̄ньщи
олыс	о̄лыс
мот	мо̄т
савсыр	са̄всыр
хотпа	хо̄тпа
няврамыт	ня̄врамыт
элаль	э̄лаль
лавыс	ла̄выс
латыӈ	ла̄тыӈ
пес	пе̄с
павылт	па̄вылт
олэгыт	о̄лэ̄гыт
эри	э̄ри
латӈыл	ла̄тӈыл
магсыл	ма̄гсыл
вармаль	ва̄рмаль
юи-палт	юи-па̄лт
хотал	хо̄тал
няврам	ня̄врам
эрнэ	э̄рнэ
танки	та̄нки
ма	ма̄
сотыра	со̄тыра
тэла	тэ̄ла
варуӈкве	ва̄руӈкве
нэпак	нэ̄пак
варнэ	ва̄рнэ
павыл	па̄выл
Хальӯс	Ха̄льӯс
маньлат	ма̄ньлат
маньлат	ма̄ньла̄т
махманув	ма̄хманув
щань	ща̄нь
хот	хо̄т
маныл	ма̄ныл
тара	та̄ра
этпос	э̄тпос
рови	ро̄ви
олсыт	о̄лсыт
Тонт	То̄нт
элы-палт	э̄лы-па̄лт
элы-палт	э̄лы-палт
нэпакыт	нэ̄пакыт
тэлат	тэ̄лат
элумхолас	э̄лумхо̄лас
салы	са̄лы
тонт	то̄нт
хоталэт	хо̄талэ̄т
хоталэт	хо̄талэт
патэгыт	патэ̄гыт
танти	та̄нти
рӯпитэгыт	рӯпитэ̄гыт
варум	ва̄рум
олуӈкве	о̄луӈкве
олум	о̄лум
това	то̄ва
павылн	па̄вылн
Маньщи	Ма̄ньщи
емтыс	е̄мтыс
солкови	солко̄ви
хотпаг	хо̄тпаг
оньщи	о̄ньщи
вармалит	ва̄рмалит
вермегыт	ве̄рме̄гыт
Мот	Мо̄т
щемьят	ще̄мьят
ати	а̄ти
тавен	таве̄н
тарвитыӈ	та̄рвитыӈ
ляххал	ля̄ххал
Пес	Пе̄с
атим	а̄тим
тэн	тэ̄н
тэнут	тэ̄нут
тананыл	та̄наныл
варегыт	ва̄ре̄гыт
олнэ	о̄лнэ
олнэ	олнэ̄
Няврамыт	Ня̄врамыт
ощнэ	о̄щнэ
махумн	ма̄хумн
емты	е̄мты
тананылн	та̄нанылн
савит	са̄вит
ойка	о̄йка
овылтыт	о̄вылтыт
янас	я̄нас
хоталт	хо̄талт
оньщегыт	о̄ньще̄гыт
хон	хо̄н
Тэн	Тэ̄н
варыс	ва̄рыс
таимагыс	таима̄гыс
ват	ва̄т
нан	на̄н
овлэт	о̄влэ̄т
овлэт	о̄влэт
савнув	са̄внув
ватихал	ва̄тихал
товлыс	то̄влыс
вараве	ва̄раве
Молты	Мо̄лты
агм	а̄гм
Овлэт	О̄влэ̄т
Овлэт	О̄влэт
пасныл	па̄сныл
эква	э̄ква
верми	ве̄рми
эргыт	э̄ргыт
Торум	То̄рум
ворт	во̄рт
пустагыл	пуста̄гыл
манавн	ма̄навн
ёхталэгыт	ёхталэ̄гыт
павылныл	па̄вылныл
варсыт	ва̄рсыт
лави	ла̄ви
лававе	ла̄ваве
олэг	о̄лэ̄г
анумн	а̄нумн
павлыӈ	па̄влыӈ
вари	ва̄ри
варвес	ва̄рвес
варвес	ва̄рве̄с
катыл	ка̄тыл
нэматыр	нэ̄матыр
ма-хум	ма̄-хум
майвесыт	майве̄сыт
латӈаныл	ла̄тӈаныл
варим	ва̄рим
ищхипыӈ	ищхӣпыӈ
потыртэгыт	потыртэ̄гыт
ма-вит	ма̄-вит
маньщит	ма̄ньщит
хотал	хо̄тал
тэлы	тэ̄лы
хотпатн	хо̄тпатн
Таимагыс	Таима̄гыс
лавегыт	ла̄ве̄гыт
лагыл	ла̄гыл
ма-вой	ма̄-во̄й
ма-вой	ма̄-вой
тарвит	та̄рвит
латӈыг	ла̄тӈыг
ванэ	ва̄нэ
лавсыт	ла̄всыт
олупсаныл	о̄лупсаныл
эрегыт	э̄ре̄гыт
кат	ка̄т
нэпакн	нэ̄пакн
Нан	На̄н
мойтыт	мо̄йтыт
ваганыл	ва̄ганыл
олупса	о̄лупса
щемья	ще̄мья
эрыг	э̄рыг
товат	то̄ват
тэланыл	тэ̄ланыл
этпост	э̄тпост
минэгыт	минэ̄гыт
вор	во̄р
Саранпавылт	Саранпа̄вылт
лавегум	ла̄ве̄гум
мат	ма̄т
олнэ	о̄лнэ
олнэ	олнэ̄
латӈыт	ла̄тӈыт
варавет	ва̄равет
матыр-ати	матыр-а̄ти
солковил	солко̄вил
варыглавес	ва̄рыглавес
Савсыр	Са̄всыр
сав	са̄в
агмыл	а̄гмыл
атимыг	а̄тимыг
емтыс	е̄мтыс
мойт	мо̄йт
мавт	ма̄вт
ма	ма̄
вармаляныл	ва̄рмаляныл
хотпан	хо̄тпан
Саранпавыл	Саранпа̄выл
хоталэ	хо̄талэ
хоталэ	хо̄талэ̄
нэпакыл	нэ̄пакыл
нэмхотьют	нэ̄мхотьют
мен	ме̄н
мав	ма̄в
яныгпала	яныгпа̄ла
нявраманыл	ня̄враманыл
патэв	патэ̄в
олэв	о̄лэ̄в
касащегыт	ка̄саще̄гыт
оньщев	о̄ньще̄в
матэ	ма̄тэ
хансэгыт	хансэ̄гыт
нох-винэ	но̄х-винэ
савыӈпалэ	са̄выӈпа̄лэ
най	на̄й
махманэ	ма̄хманэ
щагтым	ща̄гтым
олсыг	о̄лсы̄г
олсыг	о̄лсыг
латӈув	ла̄тӈув
лавме	ла̄вме
ваӈкве	ва̄ӈкве
ялантэгыт	ялантэ̄гыт
магсыланыл	ма̄гсыланыл
манки	ма̄нки
эрыс	э̄рыс
Мен	Ме̄н
варев	ва̄ре̄в
ятил	я̄тил
нох-патыс	но̄х-патыс
вагыт	ва̄гыт
хонт	хо̄нт
Ас-угорский	А̄с-угорский
хонтлын	хо̄нтлын
юи-овыл	юи-о̄выл
Маньлат	Ма̄ньлат
Маньлат	Ма̄ньла̄т
емтэгыт	е̄мтэ̄гыт
эргысыт	э̄ргысыт
каркам	ка̄ркам
Лӯима	Лӯима̄
Юи-овыл	Юи-о̄выл
нэпаканыл	нэ̄паканыл
ханищтахтэгыт	ханищтахтэ̄гыт
лававет	ла̄вавет
Лопмус	Ло̄пмус
йиквнэ	йӣквнэ
Ӯринэква	Ӯринэ̄ква
хоталыт	хо̄талыт
нянь	ня̄нь
лаввес	ла̄ввес
лаввес	ла̄вве̄с
Хальӯст	Ха̄льӯст
павлыт	па̄влыт
номсэгум	номсэ̄гум
хотпанув	хо̄тпанув
ёхтэгыт	ёхтэ̄гыт
Атям	А̄тям
яныгсат	яныгса̄т
латӈе	ла̄тӈе
латӈе	ла̄тӈе̄
салыт	са̄лыт
олэн	о̄лэ̄н
олэн	о̄лэн
сэрипос	сэ̄рипос
лавев	ла̄ве̄в
похат	по̄хат
ят	я̄т
хоталыт	хо̄талыт
нанан	на̄нан
янытлавесыт	янытлаве̄сыт
олэгум	о̄лэ̄гум
эл	э̄л
маньтагыл	ма̄ньта̄гыл
таӈхегыт	таӈхе̄гыт
тасавит	таса̄вит
элы	э̄лы
ворн	во̄рн
рӯпитэв	рӯпитэ̄в
йиквсыт	йӣквсыт
олсум	о̄лсум
эрыӈ	э̄рыӈ
касащи	ка̄сащи
атям	а̄тям
анум	а̄нум
эт	э̄т
нох-патум	но̄х-патум
вораян	во̄раян
тэгыт	тэ̄гыт
ощсыт	о̄щсыт
мананыл	ма̄наныл
яласэгыт	яласэ̄гыт
хасэгыт	ха̄сэ̄гыт
хасэгыт	хасэ̄гыт
ищхипыӈ	ищхӣпыӈ
емтсыт	е̄мтсыт
молты	мо̄лты
пасыл	па̄сыл
Тэлы	Тэ̄лы
Салы	Са̄лы
хот-ати	хо̄т-а̄ти
варвесыт	ва̄рве̄сыт
астламе	а̄стламе
овылтахтас	о̄вылтахтас
нё̄тэгыт	нё̄тэ̄гыт
лавуӈкве	ла̄вуӈкве
кетум	ке̄тум
астлас	а̄стлас
матт	ма̄тт
Няхщамволь	Ня̄хщамво̄ль
оньщегум	о̄ньще̄гум
лаввесыт	ла̄вве̄сыт
верыста	ве̄рыста
мотыт	мо̄тыт
лавнэ	ла̄внэ
тотвесыт	тотве̄сыт
ойкатэ	о̄йкатэ
нэмхуньт	нэ̄мхуньт
варияныл	ва̄рияныл
няврамытн	ня̄врамытн
Ма-вит	Ма̄-вит
мотаныт	мо̄таныт
потыртэв	потыртэ̄в
вагтэ	ва̄гтэ
Щань	Ща̄нь
хасвесыт	хасве̄сыт
патвесыт	патве̄сыт
колтагыл	колта̄гыл
тованакт	то̄ванакт
атятэ	а̄тятэ
йиквуӈкве	йӣквуӈкве
манти	ма̄нти
Хотпа	Хо̄тпа
маньхапыл	ма̄ньха̄пыл
нявраманэ	ня̄враманэ
нэпаканэ	нэ̄паканэ
олупсав	о̄лупсав
нэпакт	нэ̄пакт
кетвес	ке̄твес
Ятил	Я̄тил
вермысыт	ве̄рмысыт
экватэ	э̄кватэ
Тэк	Тэ̄к
оньщег	о̄ньще̄г
Ойка	О̄йка
олсӯв	о̄лсӯв
павлувт	па̄влувт
щемьяӈ	ще̄мьяӈ
вораим	во̄раим
Ойкам	О̄йкам
ляххалыт	ля̄ххалыт
тэлан	тэ̄лан
варыгласыт	ва̄рыгласыт
Ляххал	Ля̄ххал
йиквыт	йӣквыт
тэлаг	тэ̄лаг
Саранпавылн	Саранпа̄вылн
ханищтэгыт	ханищтэ̄гыт
таӈхегум	таӈхе̄гум
оньщавет	о̄ньщавет
вармальн	ва̄рмальн
эргуӈкве	э̄ргуӈкве
Тованакт	То̄ванакт
оньщас	о̄ньщас
тэрпи	тэ̄рпи
алпыл	а̄лпыл
олме	о̄лме
хотпатын	хо̄тпатын
Павлыӈ	Па̄влыӈ
ваӈын	ва̄ӈын
эргыс	э̄ргыс
ёвтэгыт	ёвтэ̄гыт
нэпаке	нэ̄паке
Ворт	Во̄рт
варыглаве	ва̄рыглаве
агирищит	а̄гирищит
ищхипыӈ	ищхӣпыӈ
вермыс	ве̄рмыс
Павылт	Па̄вылт
товлы	то̄влы
Молал	Мо̄лал
Э̄лумхолас	Э̄лумхо̄лас
вермев	ве̄рме̄в
лапкат	ла̄пкат
павлытт	па̄влытт
хансэв	хансэ̄в
щай	ща̄й
каркамыг	ка̄ркамыг
эргын	э̄ргын
номсэгыт	номсэ̄гыт
кетуӈкве	ке̄туӈкве
щемьятэ	ще̄мьятэ
ойтэгыт	ойтэ̄гыт
латӈын	ла̄тӈын
манав	ма̄нав
Хотал	Хо̄тал
няврамаквет	ня̄врамаквет
яӈк	я̄ӈк
оньщияныл	о̄ньщияныл
Савыӈпалэ	Са̄выӈпа̄лэ
Тыимагыс	Тыима̄гыс
ваглум	ва̄глум
тэнэ	тэ̄нэ
няврамыӈ	ня̄врамыӈ
тор	то̄р
хонтлам	хо̄нтлам
нэпакыг	нэ̄пакыг
варыглавет	ва̄рыглавет
олупсатэ	о̄лупсатэ
касэгыт	касэ̄гыт
сунсэгыт	сунсэ̄гыт
Тавен	Таве̄н
Анъя	А̄нъя
ваг	ва̄г
тотэгыт	тотэ̄гыт
кетавет	ке̄тавет
касащас	ка̄сащас
хоталныл	хо̄талныл
Нэпак	Нэ̄пак
этпос	э̄тпос
хапыл	ха̄пыл
щё̄питэгыт	щё̄питэ̄гыт
Хальӯсн	Ха̄льӯсн
нох-патсыт	но̄х-патсыт
овылтахтам	о̄вылтахтам
варсӯв	ва̄рсӯв
нявраманув	ня̄враманув
рӯпитэгум	рӯпитэ̄гум
воруй	во̄руй
Хот	Хо̄т
касащасыт	ка̄сащасыт
ровыс	ро̄выс
аще	а̄ще
тотыглавесыт	тотыглаве̄сыт
таратан	та̄ратан
салыл	са̄лыл
лӯима	лӯима̄
ваве	ва̄ве
эргегыт	э̄рге̄гыт
махманыл	ма̄хманыл
агирищ	а̄гирищ
няврамытын	ня̄врамытын
вермияныл	ве̄рмияныл
салыяныл	са̄лыяныл
мананылт	ма̄нанылт
уретыл	уре̄тыл
хонтлуӈкве	хо̄нтлуӈкве
варыглэв	ва̄рыглэ̄в
алыщлэгыт	алыщлэ̄гыт
Няврам	Ня̄врам
макыг	ма̄кыг
агирищит-пыгрищит	а̄гирищит-пыгрищит
вантлыс	ва̄нтлыс
варсум	ва̄рсум
экват	э̄кват
Ма	Ма̄
воввесыт	во̄вве̄сыт
матэт	ма̄тэ̄т
аканит	а̄канит
лопс	ло̄пс
суссылтавесыт	суссылтаве̄сыт
Саранпавылныл	Саранпа̄вылныл
оньщуӈкве	о̄ньщуӈкве
вораяӈкве	во̄раяӈкве
йиквегыт	йӣкве̄гыт
нэмхот	нэ̄мхо̄т
Ойкатэ	О̄йкатэ
Ясунт	Я̄сунт
Най-Отыранэн	На̄й-О̄тыранэ̄н
ханищтавесыт	ханищтаве̄сыт
ойкам	о̄йкам
Отыр	О̄тыр
пӯмщалахтэгыт	пӯмщалахтэ̄гыт
тыхотал	тыхо̄тал
таставе	та̄ставе
нэпакын	нэ̄пакын
ищхипыӈ	ищхӣпыӈ
лахыс	ла̄хыс
этпос	э̄тпос
Ати	А̄ти
ма-витув	ма̄-витув
воввес	во̄ввес
лавнэтэ	ла̄внэ̄тэ
варыглас	ва̄рыглас
тэнутыл	тэ̄нутыл
олнэтэ	о̄лнэ̄тэ
олнэтэ	о̄лнэтэ
Лопмуст	Ло̄пмуст
таныт	та̄ныт
хультэгыт	хультэ̄гыт
манасавит	манаса̄вит
олмет	о̄лме̄т
щаил	ща̄ил
яныгмегыт	яныгме̄гыт
вовавет	во̄вавет
махмыт	ма̄хмыт
магылн	ма̄гылн
Торумн	То̄румн
кетым	ке̄тым
ваим	ва̄им
йикв	йӣкв
юи-палэт	юи-па̄лэ̄т
мащтырлан	ма̄щтырлан
молалнув	мо̄лалнув
хонтаӈ	хо̄нтаӈ
найпос	на̄йпос
атимыг	а̄тимыг
Атятэ	А̄тятэ
савиткем	са̄виткем
периявес	пе̄риявес
астласум	а̄стласум
Махманув	Ма̄хманув
этпос	э̄тпос
маг	ма̄г
мащтырлаӈкве	ма̄щтырлаӈкве
товылхаты	то̄вылхаты
тэнатэн	тэ̄натэ̄н
Яныгпала	Яныгпа̄ла
тэрпил	тэ̄рпил
нанки	на̄нки
минэв	минэ̄в
овылтавес	о̄вылтавес
мансавит	манса̄вит
периим	пе̄риим
хоталыл	хо̄талыл
ванэ	ва̄нэ
варыглэгыт	ва̄рыглэ̄гыт
нэмхотталь	нэ̄мхотталь
этпос	э̄тпос
хоталытт	хо̄талытт
периясыт	пе̄риясыт
варсаныл	ва̄рсаныл
пентсыл	пе̄нтсыл
периян	пе̄риян
атсат	атса̄т
нох	но̄х
няврамыг	ня̄врамыг
латӈанув	ла̄тӈанув
астламум	а̄стламум
элаль	э̄лаль
олнэ	о̄лнэ
олнэ	олнэ̄
агмыт	а̄гмыт
хоталт	хо̄талт
хонтуӈкве	хо̄нтуӈкве
колтаглэ	колта̄глэ
магсылэ	ма̄гсылэ
касащан	ка̄сащан
этпос	э̄тпос
ощсыг	о̄щсы̄г
ощсыг	о̄щсыг
щарги	ща̄рги
овылтахтасыт	о̄вылтахтасыт
лавнэныл	ла̄внэ̄ныл
вермегын	ве̄рмегы̄н
вермегын	ве̄рме̄гын
сэлэгыт	сэ̄лэ̄гыт
лаглыл	ла̄глыл
хап	ха̄п
мӯйлуптавесыт	мӯйлуптаве̄сыт
нэмхотьютн	нэ̄мхотьютн
олыглан	о̄лыглан
кер	ке̄р
ловиньтэгыт	ловиньтэ̄гыт
ӯнттувесыт	ӯнттуве̄сыт
хансэгум	хансэ̄гум
сэлуӈкве	сэ̄луӈкве
рӯпитэг	рӯпитэ̄г
павлытн	па̄влытн
оньщаве	о̄ньщаве
Вортур	Во̄ртур
этпос	э̄тпос
тэлатэ	тэ̄латэ
сэлнэ	сэ̄лнэ
натнэ	на̄тнэ
этпос	э̄тпос
ӯщлахтэгыт	ӯщлахтэ̄гыт
яныгхотпат	яныгхо̄тпат
ялантэгум	ялантэ̄гум
хӯнтлэгыт	хӯнтлэ̄гыт
Э̄типалаг	Э̄типа̄лаг
кетэв	ке̄тэ̄в
регыӈ	ре̄гыӈ
вавет	ва̄вет
акань	а̄кань
нявраманэн	ня̄враманэ̄н
хотпаныл	хо̄тпаныл
щаняге-ащаге	ща̄няге-а̄щаге
кетыс	ке̄тыс
Танки	Та̄нки
мавн	ма̄вн
варыглавесыт	ва̄рыглаве̄сыт
этипалаг	э̄типа̄лаг
вермегум	ве̄рме̄гум
Таимагсыл	Таима̄гсыл
Сорни	Со̄рни
Вор	Во̄р
рӯпитанэтэ	рӯпитанэ̄тэ
тартавет	та̄ртавет
мощертын	моще̄ртын
вермавет	ве̄рмавет
хонтлум	хо̄нтлум
хайтсыт	ха̄йтсыт
анеквам	ане̄квам
хотпав	хо̄тпав
сатлов	са̄тлов
номсэв	номсэ̄в
лащал-лащал	ла̄щал-ла̄щал
Ретыӈ	Ре̄тыӈ
этпос	э̄тпос
емтум	е̄мтум
аращ	а̄ращ
Нох-патум	Но̄х-патум
яӈк	я̄ӈк
натнэ	на̄тнэ
этпос	э̄тпос
Ма	Ма̄
хоталанэт	хо̄таланэ̄т
ӯнлэгыт	ӯнлэ̄гыт
хоталыг	хо̄талыг
лавсанэ	ла̄всанэ
вермаве	ве̄рмаве
экваг-ойкаг	э̄кваг-о̄йкаг
лапка	ла̄пка
емтнэ	е̄мтнэ
Алпыл	А̄лпыл
опам	о̄пам
ойкатэнтыл	о̄йкатэ̄нтыл
нявраманум	ня̄враманум
махманэн	ма̄хманэ̄н
павлытыт	па̄влытыт
махманум	ма̄хманум
хайтнэ	ха̄йтнэ
амщит	а̄мщит
овылтахтэгыт	о̄вылтахтэ̄гыт
павылквет	па̄вылквет
махманувн	ма̄хманувн
кетвесыт	ке̄тве̄сыт
патэгум	патэ̄гум
ялэгыт	ялэ̄гыт
тастым	та̄стым
манылт	ма̄нылт
сэмыл	сэ̄мыл
катын	ка̄тын
Мань	Ма̄нь
этпос	э̄тпос
олнэ	о̄лнэ
олнэ	олнэ̄
нё̄твесыт	нё̄тве̄сыт
намхоталэ	намхо̄талэ
наиӈхап	на̄иӈха̄п
наиӈхап	на̄иӈхап
ойттур	о̄йттур
этпос	э̄тпос
таксар	та̄ксар
саграп	са̄грап
нёлсат	нёлса̄т
парт	па̄рт
хонтэгыт	хо̄нтэ̄гыт
ӯнттэгыт	ӯнттэ̄гыт
павлэн	па̄влэ̄н
минэгум	минэ̄гум
атэгыт	атэ̄гыт
нэмат	нэ̄мат
вати	ва̄ти
суссылтэгыт	суссылтэ̄гыт
таимагсыл	таима̄гсыл
этпос	э̄тпос
ю̄нтэгыт	ю̄нтэ̄гыт
тастувес	та̄стувес
майвесыг	майвесы̄г
кетэгыт	ке̄тэ̄гыт
сэтапыл	сэ̄тапыл
ретыӈ	ре̄тыӈ
этпос	э̄тпос
песыг	пе̄сыг
эрги	э̄рги
тер	те̄р
ловиньтэлын	ловиньтэлы̄н
варыглаӈкве	ва̄рыглаӈкве
хотпатныл	хо̄тпатныл
таксарыг	та̄ксарыг
варегум	ва̄ре̄гум
нявраме	ня̄враме
ваглӯв	ва̄глӯв
ваганэ	ва̄ганэ
ахвтас	а̄хвтас
найив	на̄йив
найив	на̄йӣв
кивырт	кӣвырт
яныг	я̄ныг
этпос	э̄тпос
вармалянув	ва̄рмалянув
этпос	э̄тпос
эруптытэ	э̄руптытэ
таставет	та̄ставет
Молалнув	Мо̄лалнув
варыстэ	ва̄рыстэ
Хослох	Хо̄сло̄х
таӈхев	таӈхе̄в
лӯимат	лӯима̄т
нянил	ня̄нил
ваӈын	ва̄ӈын
омаге-атяге	омаге-а̄тяге
тар-витыӈ	та̄р-витыӈ
потыртэгум	потыртэ̄гум
тэнутаныл	тэ̄нутаныл
павлытныл	па̄влытныл
овылтахты	о̄вылтахты
этпос	э̄тпос
пустагыл	пуста̄гыл
олнэ	о̄лнэ
олнэ	олнэ̄
тэланэ	тэ̄ланэ
мань	ма̄нь
этпос	э̄тпос
олым	о̄лым
щё̄питавесыт	щё̄питаве̄сыт
вайхатасум	ва̄йхатасум
эруптылум	э̄руптылум
оньщимен	о̄ньщиме̄н
вантлысыт	ва̄нтлысыт
щемьяӈыг	ще̄мьяӈыг
олмыгтас	о̄лмыгтас
кетэгум	ке̄тэ̄гум
Пустагыл	Пуста̄гыл
хонтлыс	хо̄нтлыс
вагтал	ва̄гта̄л
вагтал	ва̄гтал
вагтал	вагта̄л
тэрпит	тэ̄рпит
астлам	а̄стлам
оста	о̄ста
этпос	э̄тпос
номсахтэгыт	номсахтэ̄гыт
перияӈкве	пе̄рияӈкве
щё̄питэв	щё̄питэ̄в
астлан	а̄стлан
тэнут-пормас	тэ̄нут-пормас
хапыт	ха̄пыт
ровнэ	ро̄внэ
щагт	ща̄гт
этэ-хоталэ	э̄тэ-хо̄талэ
саӈквылтаӈкве	са̄ӈквылтаӈкве
таратаӈкве	та̄ратаӈкве
саӈквылтан	са̄ӈквылтан
варыгласӯв	ва̄рыгласӯв
турлопсыт	турло̄псыт
нэпакытыл	нэ̄пакытыл
этпост	э̄тпост
хасэгум	ха̄сэ̄гум
вовегыт	во̄ве̄гыт
эрмыглы	э̄рмыглы
тэнутыт	тэ̄нутыт
таратас	та̄ратас
таккет	такке̄т
пайтнэ	па̄йтнэ
ойкат	о̄йкат
хотал	хо̄тал
элыл	э̄лыл
Опам	О̄пам
элы-пал	э̄лы-пал
элы-пал	э̄лы-па̄л
Тал	Та̄л
этпос	э̄тпос
нял	ня̄л
Най	На̄й
Ма-вой	Ма̄-во̄й
хонтхатыглап	хо̄нтхатыглап
яныгпалаг	яныгпа̄лаг
периегыт	пе̄рие̄гыт
хоталыл	хо̄талыл
хонтсыт	хо̄нтсыт
савитыг	са̄витыг
нэглыс	нэ̄глыс
мотанэ	мо̄танэ
маглын	ма̄глын
китсат	китса̄т
кетсыт	ке̄тсыт
сорни	со̄рни
апщим	а̄пщим
Танти	Та̄нти
Салыт	Са̄лыт
Най-Отыранылн	На̄й-О̄тыранылн
тал	та̄л
этпос	э̄тпос
вовыглавесыт	во̄выглаве̄сыт
экватэнтыл	э̄кватэ̄нтыл
майлувесыт	майлуве̄сыт
павлытын	па̄влытын
вуйвесыт	вуйве̄сыт
эрганыл	э̄рганыл
лавсыг	ла̄всы̄г
лавсыг	ла̄всыг
емталас	е̄мталас
тэӈкве	тэ̄ӈкве
павлыг	па̄влыг
апщитэ	а̄пщитэ
Ищхипыӈ	Ищхӣпыӈ
акван-атхатыглэгыт	акван-атхатыглэ̄гыт
лат	ла̄т
щё̄питахтэгыт	щё̄питахтэ̄гыт
касалаӈкве	ка̄салаӈкве
мӯйлэгыт	мӯйлэ̄гыт
майвесум	майве̄сум
щаняныл-ащаныл	ща̄няныл-а̄щаныл
хонтлым	хо̄нтлым
Мотаныт	Мо̄таныт
ваӈын	ва̄ӈын
нэ	нэ̄
опатэ	о̄патэ
лащал	ла̄щал
эрге	э̄рге
эрге	э̄рге̄
ват	ва̄т
саграпнал	са̄грапнал
этпос	э̄тпос
олнэ	о̄лнэ
олнэ	олнэ̄
Хорыӈпавылт	Хо̄рыӈпа̄вылт
вайхатэгыт	ва̄йхатэ̄гыт
хотхуйплов	хо̄тхуйплов
кетвесум	ке̄тве̄сум
махмытын	ма̄хмытын
кинсэгыт	кинсэ̄гыт
вовуӈкве	во̄вуӈкве
Маньщит	Ма̄ньщит
договор-нэпак	договор-нэ̄пак
налми	на̄лми
Катыл	Ка̄тыл
эрнэ	э̄рнэ
рег	ре̄г
вовиньталвесыт	во̄виньта̄лве̄сыт
вовиньталвесыт	во̄виньталве̄сыт
ханищтахтэв	ханищтахтэ̄в
послувесыт	по̄слуве̄сыт
ё̄мыгтэгыт	ё̄мыгтэ̄гыт
тыттувесыт	тыттуве̄сыт
маньщиянув	ма̄ньщиянув
хайтуӈкве	ха̄йтуӈкве
лавхатсыт	ла̄вхатсыт
вораегыт	во̄рае̄гыт
щемьяныл	ще̄мьяныл
кетыяныл	ке̄тыяныл
хонтвес	хо̄нтвес
тэланув	тэ̄ланув
салыянэ	са̄лыянэ
олымен	о̄лыме̄н
латӈанэ	ла̄тӈанэ
ащойкам	ащо̄йкам
лавсум	ла̄всум
торыл	то̄рыл
олсув	о̄лсув
найн	на̄йн
ёлы-палт	ёлы-па̄лт
Юи-овылт	Юи-о̄вылт
вантлэгыт	ва̄нтлэ̄гыт
таратасыт	та̄ратасыт
таратавес	та̄ратавес
оньщегын	о̄ньщегы̄н
оньщегын	о̄ньще̄гын
оньщегын	о̄ньщегын
Хальӯсныл	Ха̄льӯсныл
янмалтэг	янмалтэ̄г
варыглам	ва̄рыглам
вайхатас	ва̄йхатас
айтвесыт	айтве̄сыт
йикваныл	йӣкваныл
варен	ва̄ре̄н
варен	ва̄рен
тэнки	тэ̄нки
этпост	э̄тпост
тэг	тэ̄г
павланылт	па̄вланылт
колтаглыт	колта̄глыт
щащеквам	щаще̄квам
хӯрумсат	хӯрумса̄т
тыимагыс	тыима̄гыс
ровегыт	ро̄ве̄гыт
лавияныл	ла̄вияныл
ноӈхаль	но̄ӈхаль
варилӯв	ва̄рилӯв
Анеквам	Ане̄квам
хонтыс	хо̄нтыс
воруит	во̄руит
катыт	ка̄тыт
Тэнут	Тэ̄нут
ащум	а̄щум
эти	э̄ти
мал	ма̄л
йикв	йӣкв
янмалтэгыт	янмалтэ̄гыт
сатхуйплов	са̄тхуйплов
ӯрхатэгыт	ӯрхатэ̄гыт
ю̄нтэгум	ю̄нтэ̄гум
миннэныл	миннэ̄ныл
махумныл	ма̄хумныл
вораясыт	во̄раясыт
вариянӯв	ва̄риянӯв
агирищиг	а̄гирищиг
олыглам	о̄лыглам
олупсал	о̄лупсал
Тыхотал	Тыхо̄тал
атимыг	а̄тимыг
емтсыт	е̄мтсыт
тэтал	тэ̄та̄л
латӈум	ла̄тӈум
кетаве	ке̄таве
емталы	е̄мталы
тэлав	тэ̄лав
йиквыс	йӣквыс
хоталаныл	хо̄таланыл
мань	ма̄нь
этпост	э̄тпост
элын	э̄лын
агме	а̄гме
Атяв	А̄тяв
элумхоласн	э̄лумхо̄ласн
хонтлаӈкве	хо̄нтлаӈкве
тартвесыт	та̄ртве̄сыт
вовыглавес	во̄выглавес
пахвтысыт	па̄хвтысыт
павланыл	па̄вланыл
маньщииг	ма̄ньщииг
хонтлан	хо̄нтлан
пинэгыт	пинэ̄гыт
ойттур	о̄йттур
этпост	э̄тпост
щемьян	ще̄мьян
ойттал	ойтта̄л
кетэн	ке̄тэ̄н
Вораян	Во̄раян
щанит-ащит	ща̄нит-а̄щит
ощсӯв	о̄щсӯв
олсыг	о̄лсы̄г
олсыг	о̄лсыг
олмум	о̄лмум
артми	а̄ртми
кеты	ке̄ты
хонтхатыглапыт	хо̄нтхатыглапыт
ловиньтавесыт	ловиньтаве̄сыт
хайтыгтэгыт	ха̄йтыгтэ̄гыт
пахвтуӈкве	па̄хвтуӈкве
салыӈколт	са̄лыӈколт
послэгыт	по̄слэ̄гыт
хартэгыт	хартэ̄гыт
ялантэв	ялантэ̄в
тартаве	та̄ртаве
вариянэ	ва̄риянэ
Ойттур	О̄йттур
этпос	э̄тпос
элнаӈ	э̄лнаӈ
хонты	хо̄нты
сэтап	сэ̄тап
сойми	со̄йми
лэгыт	лэ̄гыт
астыс	а̄стыс
щане	ща̄не
паля	па̄ля
пакв	па̄кв
атяв	а̄тяв
Ват	Ва̄т
саграпнал	са̄грапнал
этпос	э̄тпос
тар	та̄р
сэй	сэ̄й
онь	о̄нь
уральтавесыт	уральтаве̄сыт
китыглавесыт	китыглаве̄сыт
Няхщамвольт	Ня̄хщамво̄льт
торгамтэгыт	торгамтэ̄гыт
тастувесыт	та̄стуве̄сыт
ойкаментыл	о̄йкаме̄нтыл
олмыгтасыт	о̄лмыгтасыт
нявраманын	ня̄враманын
вовыглавет	во̄выглавет
хайтэгыт	ха̄йтэ̄гыт
няврамаге	ня̄врамаге
заявление-нэпак	заявление-нэ̄пак
сунсэгум	сунсэ̄гум
лавыглас	ла̄выглас
вовияныл	во̄вияныл
ащойкатэ	ащо̄йкатэ
Тэнатэн	Тэ̄натэ̄н
Мощертын	Моще̄ртын
маньнув	ма̄ньнув
морсыӈ	мо̄рсыӈ
порат	по̄рат
эрганэ	э̄рганэ
хонтыт	хо̄нтыт
павлув	па̄влув
морсыӈ	мо̄рсыӈ
квалыг	ква̄лыг
катпос	ка̄тпос
диплом-нэпакыл	диплом-нэ̄пакыл
тэпыӈ	тэ̄пыӈ
полям	по̄лям
овыл-тыт	о̄выл-тыт
аныт	а̄ныт
Лави	Ла̄ви
Яӈк	Я̄ӈк
натнэ	на̄тнэ
этпос	э̄тпос
Ват	Ва̄т
Аще	А̄ще
овылтахтаме	о̄вылтахтаме
вайхатуӈкве	ва̄йхатуӈкве
наиӈхапыл	на̄иӈха̄пыл
наиӈхапыл	на̄иӈхапыл
щаргегыт	ща̄рге̄гыт
варнэныл	ва̄рнэ̄ныл
